akoma’é	n|-akoma’é
akoma’éramo	n|-akoma’é
akwaháwihi	n|-akwaháwihi
amýna	n|-amýn
aosé	n|-aosé
asuriní	n
asýng	n|-asýng
a’é	dem
a’éramo	dem
ené	pron.indep|-ené
eokwé	dem|-eokwé
eomí	pron.dem|-eomí
eopé	pron.dem|-eopé
hé	n
héraháwa	n
ipirá	n
isé	pron.ind
i’ónga	n.des|-’óng
kamará	n
ka’aw	n|-a’a
kosóa	n|-kosó
moroyróa	n|-moroyró
ména	n|-mén
né	pron.dep
oména	n|-mén
oré	pron.ind/pron.dep|-oré
osepé	n
pehé	pron.indep|-pehé
penapýjrapó	n|-apýj
peseopé	pron.dem|-eopé
poraké	n
pé	pron.dem
sahýa	n|-sahýa
saotía	n
sené	pron.dep|-sené
tené	pron.indep|-ené
wapýj	n|-apýj
wetatýramo	pref.corr|wet-
wetoína	pref.corr|wet-
wyngé	dem|-wyngé