asuriní	n
a’é	dem
eokwé	dem
wyngé	dem
mén	n
moroyró	n
akoma’é	n
akwaháwihi	n
amýn	n
aosé	n
apýj	n
asýk	n
asýng	n
hé	n
ipirá	n
kamará	n
osepé	n
poraké	n
kosó	n
sahýa	n
saotía	n
eomí	pron.dem
eopé	pron.dem
pé	pron.dem
né	pron.dep
sené	pron.dep
isé	pron.ind
oré	pron.ind/pron.dep
ené	pron.indep
pehé	pron.indep
a’a	n
’óng	n.des
wet pref.corr